0,0,0,0,0,0,0,0
0,s,g,0,0,g,0,0,0
0,g,gc,c,c,gc,g,0,0
0,0,c,0,0,c,0,0,0
0,0,c,0,0,c,0,0,0
0,g,gc,c,c,gc,g,0,0
0,0,g,0,0,g,0,0,0
0,0,0,0,0,0,0,0,0
