0,0,0,0,0,0,0,0,0
0,s,g,0,0,g,0,0,0
0,g,c,c,c,c,g,0,0
0,0,c,0,0,c,0,0,0
0,0,c,0,0,c,0,0,0
0,g,c,c,c,c,g,0,0
0,0,g,0,0,g,0,0,0
0,0,0,0,0,0,0,0,0
